20 20
####################
#GGGGGGGGGGGGGGGGGG#
#GGDGGGGGGGGGGGGGGG#
#GGGGGGGGGGGGGGGGGG#
#GGGGGGGGGGGGGGGGGG#
#GGGGGGGGGGGGGGGGGG#
#GGGGGGGGGGGGGGGGGG#
#GGGGGGGGGGGGGGGGGG#
#GGGSGGSGGGSGGGSGGG#
#GGGGGGGGGGGGGGGGGG#
#GGGGGGGGGGGGGGGGGG#
#GGGGGGGGGGGGGGGGGG#
#GGGGGGGGGGGGGGGGGG#
#GGSGGSGGGSGGGGSGGG#
#GGGGGGGGGGGGGGGGGG#
#GGGGGGGGGGGGGGGGGG#
#GGGGGGGGGGGGGGG####
#GGGGGGGGGGGGGGGGPP#
#GGGGGGGGGGGGGGGGPP#
####################
