20 20
####################
#GGGGGGGGGGGGGGGGGG#
#GGDGGGGGGGGGGGGGGG#
#GGGGGGGGGGGGGGGGGG#
#GGGGGGGGGGGGGGGGGG#
#GGGGGGGGGGGGGGGGGG#
#GGGGGGGGGGGGGGGGGG#
#GGGGGGGGGGGGGGGGGG#
#GGGSGGGGGGGGGGGGGG#
#GGGGGGGGGGGGGGGGGG#
#GGGGGGGGGGGGGGGGGG#
#GGGGGGGGGGGGGGGGGG#
#GGGGGGGGGGGGGGGGGG#
#GGGGGGGGGGGGGGGGGG#
#GGGGGGGGGGGGGGGGGG#
#GGGGGGGGGGGGGGGGGG#
#GGGGGGGGGGGGGGGGGG#
#GGGGGGGGGGGGGGGGPP#
#GGGGGGGGGGGGGGGGPP#
####################
